NO ./assets/brick.xpm
EA ./assets/brick.xpm
SO ./assets/brick.xpm
WE ./assets/brick.xpm

F 36,85,0
C 0,0,0


   11111111111111
   10000000001111
   10000000001111
   10110000111111
   11111111111111