NO ./assets/brick.xpm
EA ./assets/brick.xpm
SO ./assets/brick.xpm
WE ./assets/brick.xpm
		
				F 36,85,0
        C 51,53,51



		111111111111111111111111   11111111111

		1000000000110000N000000001110000000001
		10000000001100000000000100000000000001
		10110000011100000000000001111111111111
		1001000000000000000000001
111111111011000001110000000000001
100000000011000001110111111111111
11110111111111011100000010001
11110111111111011101010010001
11000000110101011100000000001
10000000000000001100000010001
10200000000000001100000010001
100000000000000011010100100011111
110000011101010111110111100000001
11110111 1110101 1 1111 100011111
11111111 1111111 111111111111 111
