NO ./assets/brick.xpm
SO ./assets/brick.xpm
WE ./assets/brick.xpm
EA ./assets/brick.xpm

C 0,0,0
F 36,85,0

   11111111111111
   1111111   1111111
   10000001 1000111
   10110011111111
   11111111111111