C 0,255,0 
F 1,0,0

NO ./assets/brick.xpm
SO ./assets/eagle.xpm
WE ./assets/mossy.xpm
EA ./assets/eagle.xpm

11111111111111
11110000000011
10000000000011
1011000N111011
11111111111111

