NO ./assets/brick.xpm
SO ./assets/brick.xpm
WE ./assets/brick.xpm
EA ./assets/brick.xpm

C 0,0,0
F 36,85,0

   11111111111111
   10000000001111
   100000W0001111
   10110000111111
   11111111111111