C 0,255,0
F 0,0,0

NO ./assets/brick.xpm
SO ./assets/eagle.xpm
WE ./assets/mossy.xpm
EA ./assets/barrel.xpm0

11111111111111
11110000001111
10000000001111
10110000111111
11111111111111  
  
1