NO ./assets/brick.xpm
SO ./assets/brick.xpm
WE ./assets/brick.xpm
EA ./assets/brick.xpm

C 0,0,0
F 36,85,0

   11111111111111
   10000000001111
   10000000000001
   1011000E000001
   11111111111111
