NO ./assets/brick.xpm
NO ./assets/brick.xpm
SO ./assets/brick.xpm
WE ./assets/brick.xpm
		
F 36,85,0
C 51,53,51



		1111111111111111111111111  11111111111
		1000000000110000N0000000 1110000000001
		10000000001100000000000100000000000001
		10110000011100000000000001111111111111
		1001000000000000000000001
111111111011000001110000000000001
100000000011000001110111111111111
11110111111111011100000010001
11110111111111011101010010001
11000000110101011100000000001
10000000111110001100000010001
10200001    1001100000010001
1000000011111100011010100100011111
110000011101010111110111100000001
11110111 1110101 1 1111 100011111
11111111 1111111 111111111111 111
