NO ./assets/eagle.xpm
EA ./assets/brick.xpm
SO ./assets/tree.xpm

F 36,85,0
C 255,153,51
WE ./assets/mossy.xpm
 
 
        1111111111111111111111111
        1000000000110000000000001
        1011000001110000000000001
        1001000000000000000000001
111111111011000001110000000000001
100000000011000001110111110111111
11110111111111011100000010001
111101110000N0000001010010001
1100000011010101110000001001
1000000000000000110000000001
10000000000000001101010010001
1100000111010101111101111000111
11110111 1110101 100000010001
11111111 1111111 111111111111
