NO ./assets/brick.xpm
EA ./assets/brick.xpm
SO ./assets/brick.xpm
WE ./assets/brick.xpm

F 36,85,0
C 0,0,0
 
 
111111111111111111111111111111111111111111
100000000000000000000000000000000000000001
100000000000000000000000000000000000000001
100000000000000000000000000000000000000001
100000000000000000000000000000000000000001
10000000000000000000N000000000000000000001
100000000000000000000000000000000000000001
100000000000000000000000000000000000000001
100000000000000000000000000000000000000001
100000000000000000000000000000000000000001
100000000000000000000000000000000000000001
100000000000000000000000000000000000000001
111111111111111111111111111111111111111111
